level
0

map
    #####
    #@  #
    #$ $#
  ###   ###
  #  $$   #
### # ### #     ######
#   # ### #######  OO#
# $  $             OO#
##### #### # ####  OO#
    #      ###  ######
    ########
